NO ./textures/north.xpm
SO ./textures/test.xpm
WE ./textures/west.xpm
EA ./textures/east.xpm
DO ./textures/door.xpm

F 27,0,100
C 225,30,0

1111111111111111111
1000000000000000001
1000N0000000D00001
1000000000000000001
10000000000000000001
10001000000001000001
100000000000000000001
10001000000001000001
100000000000000000001
10001000000001000001
100000000000000000001
10001000000001000001
100000000000000000001
10001000000001000001
100000000000000000001
10000000000000000001
1000100D00D0010D001
1000100000000100001
1111111111111111111
