NO ./textures/north.xpm
SO ./textures/test.xpm
WE ./textures/west.xpm
EA ./textures/east.xpm

F 220,100,0
C 225,30,0

1111111111111111111111111
1000000000110000000000001
1011000001110000000000001
1001000000000000000000001
111111111011000001110000000000001
100000000011000001110111111111111
11110011111111011100000010001
11110011111111011101010010001
11000000110101011100000010001
10000000000000001100000010001
10000000000000001101010010001
1100N0011101010111110111100111
11110111111110101101111010001
11111111111111111111111111111