NO ./textures/north.xpm
SO ./textures/test.xpm
WE ./textures/west.xpm
EA ./textures/east.xpm
DO ./textures/door.xpm

F 27,0,100
C 225,30,0

11111111
100000011111111111111
100000000000000100001
100000000000000D00001
100000000000000100001
100000000000000100001
1000000000000010000D1
100000000000000D00001
100000000000000100001
100000000000000100001
100000000000000100001
100000000000000D00001
100000000000000100001
100000000000000100001
100000000N00000D00001
100000000000000100001
100000000000000100001
111111111111111111111
