NO ./textures/north.xpm
SO ./textures/south.xpm  
WE ./textures/west.xpm
EA ./textures/east.xpm

F 220,100,0
C 225,30,0

11111111111111111111111111
10000000001100000000000011
10110000011100000000000011
10010000000000000000000011
11111111101100000111000011
10000000001100000111011111
11110111111111011100000011
11110111111111011101010011
11000000110101011100000011
10000000000000001100000011
1000000000000000110101001111111
1100000110010101111101111000001
1111011110110101101111011111111
11111111101111111111111111
11111111101111111111111111
10000000001100000000000011
1011000001110000000000001111
10010000N000000000000000000011
11111111101100000111000011111
10000000001100000111011111
11110111111111011100000011
11110111111111011101010011
11000000110101011100000011
10000000000000001100000011
10000000000000001101010011
11000001110101011111011111
11110111111101011011110111
11111111111111111111111111