NO ./textures/north.xpm
SO ./textures/test.xpm
WE ./textures/west.xpm
EA ./textures/east.xpm
DO ./textures/door.xpm

F 220,100,0
C 225,30,0

111111111
110000001
1110N0001
11110D001
111111111

